222222222222222222222222222222222222222222222222222222222222
211111211111111111111111111111111111111111111121111111111112
214111111111111111111111111111111111111122222111222222111112
211111222222212222222222222222222222222122222222222222112222
222222221111111111111111116111111111111121111161111111111112
222222221222222222222222212222222222222222222222222212222222
211111111111111111111111111111116111111111111211111116111112
222222122222221222222222222212222222222122222212222222222222
211111121111111111111111111111111111111111111111112221111112
212121221122221222111111112222221111122222221121211111111112
211611221121111112111111111111121111111111116121222211222112
212121221121222112112222222121121222211222221121211111211112
211111221121222112112111112121121111111111111111211221211112
212121111111222112112222222121122222211111111111111221212222
212121222111111112111111116111111111111111111611211111111112
211111222222112222122222222222222222122122222222222222222212
212221221112112222122222222222222222122122211112222222111112
261111111211612222122222222222222111111122111211112222112222
222222222222222222111111111111111122222222122222211111111112
222222222222222222222222222222222222222222122222222222222222
211111111111111111111111111111111111111111111111111111111112
222222222222212222221222222222212222222222222122222221222222
211111111111112111111211116111111112111111111111121111111112
212222212222222222221222222222222212222221222222222122222222
211111111111111111121111111111111111111111111111111122222222
212211222222222222222222222222222222222222222222222222555552
211111222222111222221111111111111111111111111111111111555552
211111111111121111111111111111111111111111111111111112555552
222222222222222222222222222222222222222222222222222222222222